11111
1C101
11101
1P0E1
11111
