1111111
1C10001
1010101
1000101
1011101
1P1E101
1111111
