11111
1C101
10001
1P1E1
11111
