11111111
10CCC001
11CCC001
1P0000E1
11111111
