1111111111111111111111111111111111
1E0000000000000C00000C000000000001
1010010100100000101001000000010101
10100100101010100010010000@0010101
100000000C00C0000000000000000000C1
100@000001111111111101100000000001
1010010101100000101000100000010101
1010010011101010000100100000010101
100000000C00C00000P0001000100001C1
1111111111111111111111111111111111
