111111111111111111111111111111111
1E0000000000000C00000C00000000001
101001010010000010100100000010101
101001001010101000100100000010101
100000000C00C000000000000000000C1
100000000111111111111100000000001
101001010110000010100100000010101
101001001110101000100100000010101
100000000C00C0000P0001000100001C1
111111111111111111111111111111111
