111111111111111111111111
1E000000000C000C000000C1
101001010010000010100001
101001001010101000100101
100000000C00C000000000C1
1000P0000000000C00000C01
101001010010000010100001
101001001010101000100001
100000000C00C000000000C1
111111111111111111111111
