111111111111
1000000000C1
100011111111
1P00000000E1
111111111111
