1111111
1C10001
1010101
1000001
1011101
1P1E001
1111111
