1111111111111
1000000000E11
1011111111111
1000000000001
101010101@101
1001010101001
101000000C101
1010101010101
1010@10101001
1010000000001
1011111111111
10000000000P1
1111111111111
