111111111111
100000000001
100011111111
1P00000000E1
111111111111
