11111
1C101
10E01
1PE01
11111
