11111
1C101
11101
1P1E1
11111
