11111
1C101
10001
1P101
11111
