11111111
100000E1
10000111
100110y1
10000001
10000111
1P0000C1
11111111
